**************************************************
**********************    1   ********************
*******************              *****************
*****************                 ****************
***************                     **************
*************                         ************
************                           ***********
************                           ***********
***********                             **********
**********                               *********
**********                               *********
*********                                 ********
********                                   *******
*******                                     ******
******                                       *****
******                                       *****
******                                       *****
******                                       *****
******                                       *****
******                                       *****
*******                                     ******
********                                   *******
*********                                 ********
*********                                 ********
**********                               *********
***********                             **********
***********                             **********
************                           ***********
*************                         ************
**************                       *************
***************                     **************
*****************                 ****************
*******************             ******************
*********************    2   *********************
**************************************************
